        ╔═══════════╗       ╔═══╗                       ╔═══╗                    
        ║           ║       ║   ║                       ║   ║                    
        ║   ╥   ╥   ╠═══════╣   ╚═══════╦═══════════╗   ║   ╚═══════════╗        
        ║   ║   ║   ║       ║           ║           ║   ║               ║        
╔═══════╩═══╝   ║   ╨   ╥   ╚═══╗   ╥   ╚═══╡   ╥   ╠═══╝   ╞═══╗   ╞═══╩═══════╗
║               ║       ║       ║   ║           ║   ║           ║               ║
╚═══════╗   ╔═══╩═══════╬═══╗   ║   ╚═══╦═══════╣   ╚═══╦═══════╣   ╞═══╗   ╔═══╝
        ║   ║           ║   ║   ║       ║       ║       ║       ║       ║   ║    
    ╔═══╝   ╨   ╞═══╗   ║   ╨   ╠═══╡   ║   ╥   ╚═══╗   ╨   ╥   ╠═══╡   ║   ╚═══╗
    ║               ║   ║       ║       ║   ║       ║       ║   ║       ║       ║
    ║   ╞═══╦═══════╝   ║   ╞═══╝   ╔═══╩═══╝   ╥   ╠═══════╣   ╚═══╗   ║   ╥   ║
    ║       ║           ║           ║           ║   ║       ║       ║   ║   ║   ║
╔═══╩═══╡   ║   ╞═══╦═══╩═══════════╣   ╥   ╔═══╣   ╠═══╡   ╠═══╗   ║   ║   ╠═══╝
║           ║       ║               ║   ║   ║   ║   ║       ║   ║   ║   ║   ║    
╚═══════════╩═══╗   ║   ╔═══════╗   ╚═══╣   ║   ╨   ╨   ╥   ╨   ║   ╚═══╣   ║    
                ║   ║   ║       ║       ║   ║           ║       ║       ║   ║    
    ╔═══════════╣   ║   ║   ╞═══╬═══╡   ║   ║   ╔═══════╩═══════╩═══╗   ║   ╚═══╗
    ║           ║   ║   ║       ║       ║   ║   ║                   ║   ║       ║
╔═══╝   ╔═══╡   ║   ║   ║   ╥   ║   ╔═══╝   ╚═══╣   ╞═══╦═══════╗   ╨   ║   ╔═══╝
║       ║       ║   ║   ║   ║   ║   ║           ║       ║       ║       ║   ║    
╚═══╗   ║   ╔═══╝   ║   ╚═══╣   ║   ╚═══════╗   ╚═══╗   ╚═══╗   ╚═══════╝   ║    
    ║   ║   ║       ║       ║   ║           ║       ║       ║               ║    
    ║   ║   ╨   ╔═══╩═══╡   ║   ╚═══════════╣   ╥   ╚═══╗   ╚═══╡   ╔═══╡   ║    
    ║   ║       ║           ║               ║   ║       ║           ║       ║    
╔═══╣   ╚═══════╝   ╔═══════╣   ╔═══════╗   ╨   ╠═══╡   ╚═══════╦═══╝   ╔═══╝    
║   ║               ║       ║   ║       ║       ║               ║       ║        
║   ╠═══════════╦═══╝   ╔═══╝   ╠═══╡   ╚═══╦═══╣   ╞═══════════╝   ╔═══╝        
║   ║           ║       ║       ║           ║   ║                   ║            
║   ╨   ╥   ╔═══╝   ╥   ║   ╞═══╣   ╔═══╡   ║   ╚═══╦═══════════════╩═══════════╗
║       ║   ║       ║   ║       ║   ║       ║       ║                           ║
╚═══════╣   ║   ╞═══╣   ╚═══╗   ║   ║   ╞═══╝   ╥   ╚═══╡   ╔═══════╡   ╔═══════╝
        ║   ║       ║       ║   ║   ║           ║           ║           ║        
    ╔═══╝   ╚═══╗   ╠═══╡   ║   ╨   ╠═══════════╩═══════════╣   ╞═══╦═══╩═══╗    
    ║           ║   ║       ║       ║                       ║       ║       ║    
    ║   ╔═══╗   ╨   ║   ╞═══╩═══════╣   ╔═══╗   ╔═══╡   ╔═══╩═══╗   ╚═══╗   ║    
    ║   ║   ║       ║               ║   ║   ║   ║       ║       ║       ║   ║    
    ║   ╨   ╚═══╦═══╣   ╔═══╗   ╥   ╨   ╨   ║   ╚═══╗   ║   ╥   ╠═══╡   ╨   ║    
    ║           ║   ║   ║   ║   ║           ║       ║   ║   ║   ║           ║    
    ╚═══╗   ╔═══╝   ╚═══╝   ╚═══╣   ╔═══╗   ╚═══╗   ╚═══╝   ║   ╨   ╔═══╗   ║    
        ║   ║                   ║   ║   ║       ║           ║       ║   ║   ║    
        ╚═══╝                   ╚═══╝   ╚═══════╩═══════════╩═══════╝   ╚═══╝    