                        ╔═══════════╗   ╔═══════╗       ╔═══╗   ╔═══════╗        
                        ║           ║   ║       ║       ║   ║   ║       ║        
    ╔═══╗   ╔═══════════╩═══╗   ╞═══╩═══╩═══╗   ╚═══╗   ║   ╚═══╝   ╔═══╝        
    ║   ║   ║               ║               ║       ║   ║           ║            
╔═══╝   ╚═══╝   ╔═══════╗   ╚═══╡   ╔═══╗   ╠═══╡   ║   ╠═══╡   ╥   ╠═══╗        
║               ║       ║           ║   ║   ║       ║   ║       ║   ║   ║        
║   ╞═══════════╩═══╗   ╚═══════╦═══╝   ╨   ╨   ╔═══╩═══╣   ╞═══╣   ╨   ╚═══════╗
║                   ║           ║               ║       ║       ║               ║
╚═══════════════╗   ╠═══╡   ╥   ║   ╔═══╦═══════╝   ╥   ║   ╥   ╚═══╦═══════╗   ║
                ║   ║       ║   ║   ║   ║           ║   ║   ║       ║       ║   ║
            ╔═══╝   ║   ╞═══╩═══╝   ║   ║   ╞═══════╣   ╚═══╩═══╗   ╨   ╥   ║   ║
            ║       ║               ║   ║           ║           ║       ║   ║   ║
        ╔═══╝   ╥   ╚═══╗   ╞═══════╝   ╠═══╦═══╡   ╠═══╦═══╡   ║   ╔═══╝   ╠═══╝
        ║       ║       ║               ║   ║       ║   ║       ║   ║       ║    
        ╚═══════╩═══╗   ╠═══════╦═══╗   ╨   ║   ╔═══╝   ║   ╞═══╩═══╝   ╥   ╚═══╗
                    ║   ║       ║   ║       ║   ║       ║               ║       ║
    ╔═══════════╦═══╝   ╨   ╥   ║   ╚═══╗   ║   ║   ╞═══╬═══════════╦═══╩═══╡   ║
    ║           ║           ║   ║       ║   ║   ║       ║           ║           ║
    ║   ╥   ╥   ╠═══════╗   ║   ╚═══╗   ╨   ║   ║   ╥   ║   ╔═══╗   ║   ╔═══════╣
    ║   ║   ║   ║       ║   ║       ║       ║   ║   ║   ║   ║   ║   ║   ║       ║
╔═══╩═══╝   ║   ╨   ╥   ╠═══╩═══╗   ║   ╔═══╝   ║   ║   ╨   ║   ║   ╨   ╨   ╥   ║
║           ║       ║   ║       ║   ║   ║       ║   ║       ║   ║           ║   ║
║   ╞═══════╩═══════╣   ╨   ╥   ╨   ║   ╚═══════╣   ╚═══════╝   ╠═══════╦═══╩═══╝
║                   ║       ║       ║           ║               ║       ║        
╚═══════════╗   ╥   ╚═══╦═══╩═══════╬═══════╡   ╚═══════╦═══╡   ║   ╥   ╚═══════╗
            ║   ║       ║           ║                   ║       ║   ║           ║
╔═══════════╣   ╚═══╗   ║   ╔═══╗   ╠═══════════════╦═══╝   ╔═══╝   ╠═══╡   ╥   ║
║           ║       ║   ║   ║   ║   ║               ║       ║       ║       ║   ║
║   ╞═══╗   ╠═══╡   ║   ╨   ║   ║   ╨   ╞═══╦═══╡   ║   ╔═══╩═══════╝   ╔═══╩═══╝
║       ║   ║       ║       ║   ║           ║       ║   ║               ║        
╚═══╗   ╚═══╝   ╔═══╩═══════╝   ╚═══╦═══════╝   ╥   ║   ║   ╔═══════╗   ╠═══════╗
    ║           ║                   ║           ║   ║   ║   ║       ║   ║       ║
    ║   ╞═══════╣   ╥   ╞═══╦═══════╝   ╔═══════╝   ║   ║   ║   ╞═══╝   ╨   ╔═══╝
    ║           ║   ║       ║           ║           ║   ║   ║               ║    
    ╠═══════╗   ╚═══╩═══╡   ║   ╞═══════╩═══════════╝   ╨   ║   ╔═══╦═══╡   ║    
    ║       ║               ║                               ║   ║   ║       ║    
╔═══╝   ╥   ╚═══════════╡   ╠═══════╦═══════╦═══════╦═══╡   ╠═══╝   ╚═══╗   ║    
║       ║                   ║       ║       ║       ║       ║           ║   ║    
║   ╔═══╩═══════╗   ╔═══╗   ╨   ╥   ╨   ╔═══╝       ╚═══════╝           ╚═══╝    
║   ║           ║   ║   ║       ║       ║                                        
╚═══╝           ╚═══╝   ╚═══════╩═══════╝                                        